0--3-----3--0
0----4------0
011111111---0
0----3------0
0--------4--0
0---111111110
0-----------0
0-4---------0
0111111211110