0--3---053--0
0----4------0
011111111---0
0----35-----0
0--------4--0
0---111111110
0--------5--0
0---4-------0
0221111111110
