0--3-5---3--0
0----4------0
011111111---0
0-------5---0
0--------4--0
0---111111100
0-----------0
0-----4---6-0
0221111111110